%%%%%%%%%
%   E#  %
% %#%#% %
%  B    %
%%%%%%%%%