%%%%%%%%%%%%%%%%%%%
%........%........%
%o%%.%%%.%.%%%.%%o%
%........P........%
%.%%.%.%%%%%.%.%%.%
%....%...%...%....%
%%%%.%%% % %%%.%%%%
%%%%.%  G    %.%%%%
%%%%.% %% %% %.%%%%
%%%%P  %GGG%  P%%%%
%%%%.% %%%%% %.%%%%
%%%%.%       %.%%%%
%%%%.% %%%%% %.%%%%
%........%........%
%.%%.%%%.%.%%%.%%.%
%o.%.....P.....%.o%
%%.%.%.%%%%%.%.%.%%
%....%...%...%....%
%.%%%%%%.%.%%%%%%.%
%.................%
%%%%%%%%%%%%%%%%%%%