XXXXXXXXXXXXXXXXXXXX
XM  XF X P  X      X
X      X    X  F   X
XXXX   X    X      X
X FX  XXXXX    P   X
X  X       P       X
X XXXXXX           X
X    F X  P XXXXX  X
X   XXXXXXXXX    F X
XX     F    X  F   X
XX XXXXXX P X  X X X
XX   FX     X  P   X
XX  XXXXX  X     P X
X       X  X P     X
X X FFP X       XXXX
X XXXXX X        P X
XPXF    X  E   X  FX
XXXXXXXXXXXXXXXXXXXX